# deleted postag entries
#-------------------------------------------------------------------------------
# Do not add words here, but report them to languagetool@taaltik.nl
#-------------------------------------------------------------------------------
aardappelmes	aardappelmes	ZNW:EKV
afgekruid	afgekruid	ZNW:EKV
backoffice	backoffice	ZNW:EKV:HET
dankzijde	dankzijde	ZNW:EKV:DE_
dei	dei	UNSPECIFIED
ereterras	ereterras	ZNW:EKV
felomstreden	felomstreden	ZNW:EKV
geluidsnelheid	geluidsnelheid	ZNW:EKV:DE_
helikopterview	helikopterview	ZNW:EKV:DE_
helikopterviews	helikopterview	ZNW:MRV:DE_
hoefkade	hoefkade	ZNW:EKV
humidoren	humidor	ZNW:MRV:DE_
jeugden	jeugd	ZNW:MRV:DE_
kokscholen	kokschool	ZNW:MRV:DE_
kokschool	kokschool	ZNW:EKV:DE_
kolenstoken	kolenstook	ZNW:MRV:DE_
lampfittings	lampfitting	ZNW:MRV:DE_
logementschepen	logementschip	ZNW:MRV:DE_
logementschip	logementschip	ZNW:EKV:HET
luidop	luidop	ZNW:EKV:DE_
moederkant	moederkant	ZNW:EKV
onderduikstertje	onderduikster	ZNW:EKV:VRK:HET
ondereen	ondereen	ZNW:EKV:DE_
pais	pais	ZNW:EKV:DE_
pinbon	pinbon	ZNW:EKV
snelheidstrein	snelheidstrein	ZNW:EKV:DE_
snelheidstreinen	snelheidstrein	ZNW:MRV:DE_
supergave	supergave	ZNW:EKV:DE_
supergaven	supergave	ZNW:MRV:DE_
tegeneen	tegeneen	ZNW:EKV:DE_
topbasketbal	topbasketbal	ZNW:EKV
tromper	tromper	ZNW:EKV
trompers	tromper	ZNW:MRV:DE_
trompertje	tromper	ZNW:EKV:VRK:HET
trompertjes	tromper	ZNW:MRV:VRK:DE_
tuinslag	tuinslag	ZNW:EKV
tuinslagen	tuinslag	ZNW:MRV:DE_
tuttifrutti's	tuttifrutti	ZNW:MRV:DE_
upbeat	upbeat	ZNW:EKV
va	va	ZNW:EKV:DE_
veelplezier	veelplezier	ZNW:EKV
vree	vree	ZNW:EKV:DE_
weiwater	weiwater	ZNW:EKV:HET
welnee	welnee	ZNW:EKV:HET
zelfspotje	zelfspot	ZNW:EKV:VRK:HET
zelfspotten	zelfspot	ZNW:MRV:DE_
zuigauto	zuigauto	ZNW:EKV
Abbing	Abbing	UNSPECIFIED
Abbink	Abbink	UNSPECIFIED
Pietersen	Pietersen	UNSPECIFIED
va's	va	ZNW:MRV:DE_
alsdan	alsdan	ZNW:EKV:DE_
aardling	aardling	ZNW:EKV
zinkings	zinking	ZNW:MRV:DE_
Aafke	Aafke	UNSPECIFIED
Aantjes	Aantjes	UNSPECIFIED
Janssen	Janssen	ZNW:EKV
Kamper	Kamper	UNSPECIFIED
seelachs	seelachs	UNSPECIFIED
overreageerd	overreageerd	UNSPECIFIED
moesteen	moesteen	UNSPECIFIED
pandajong	pandajong	UNSPECIFIED
paarmaanden	paarmaanden	UNSPECIFIED
nietsmeer	nietsmeer	ZNW:EKV:HET
veelgeld	veelgeld	ZNW:EKV:HET
biedteen	biedteen	UNSPECIFIED
paarminuten	paarminuten	ZNW:MRV:DE_
neustong	neustong	UNSPECIFIED
jankstengel	jankstengel	ZNW:EKV:DE_
Bisdom	Bisdom	ENM:PER:LST:NIX
Abbinks	Abbink	ENM:BEZ
Bisdoms	Bisdom	ENM:BEZ
